require("apps")

return {
   chromium                  = "chromium",
   ["chromium-tor"]          = "chromium-tor",
   firefox                   = "firefox",
   midori                    = "midori",
   luakit                    = "luakit",
   xombrero                  = "xombrero",
   dwb                       = "dwb",
   deluge                    = "deluge-gtk",
   amule                     = "amulegui",
   pidgin                    = "pidgin",
   skype                     = "skype",
   guvcview                  = "guvcview",
   quodlibet                 = "quodlibet",
   goldendict                = "goldendict",

   pavucontrol               = "pavucontrol",
   equalizer                 = "qpaeq",
   qjackctl                  = "qjackctl",
   pachage                   = "pachage",

   keepass                   = "keepassx",
   ["gnome-control-center"]  = "gnome-control-center",
   ["disk-utility"]          = "gnome-disks",
   ["cairo-compmgr"]         = "cairo-compmgr --configure",
   unison                    = "unison-gtk2",
   virtualbox                = "virtualbox",

   matlab                    = "matlab",
   sage                      = "urxvt -e sage",
   maple                     = "xmaple",
   octave                    = "octave",
   stellarium                = "stellarium",
   boinc                     = "boincm",

   calibre                   = "systemctl --user start calibre.service",
   emacs                     = "emacsclient -c -a emacs",
   irc                       = "emacs -irc",
   gnus                      = "emacs -gnus",
   org                       = "emacs -org",
   xournal                   = "xournal",
   libreoffice               = "libreoffice",
   gcstar                    = "gcstar",
   gnaural                   = "gnaural",

   gimp                      = "gimp",
   inkscape                  = "inkscape",
   blender                   = "blender",
   luxrender                 = "luxrender",
   scribus                   = "scribus",
   qcad                      = "qcad",
   sigil                     = "sigil",
   pdfeditor                 = "pdfeditor",
   k3dsurf                   = "k3dsurf",
   kpovmodeler               = "kpovmodeler",
   openoffice                = "soffice",

   ardour                    = "ardour2",
   rosegarden                = "rosegarden",
   denemo                    = "denemo",
   avidemux                  = "avidemux2_gtk",
   subtitleeditor            = "subtitleeditor",
   tagtool                   = "tagtool",
   puddletag                 = "puddletag",
   brasero                   = "brasero",

   nautilus                  = "nautilus",
}
